.XXX....XXXXXXX
.XXX.XX.XX...XX
..X..X..XXX.X.X
X...XXX.....X.X
XXXX....X.X...X
XX...X.X..XXX..
